1111111111111
10010000000C1
1000011111001
100011E0000P1

1111111111111